@???????????????
.##############?
..............e?
...............?
....##########.?
....#..........?
....#..........?
...##........##?
.##e...........?
.######........?
...............?
###....f????????